{
  "mapId": "area3_castle_1f",
  "name": "古城セレスティア・1階",
  "type": "dungeon",
  "cols": 35,
  "rows": 35,
  "isSafe": false,
  "encounterRate": 0.1,
  "encounterTable": "castle_1f",
  "isOutdoor": false,
  "area": "area3",
  "isDesolated": true,
  "desolationLevel": 0.5,
  "data": [
    [7,7,7,7,7,7,7,7,7,7,7,7,7,7,7,7,7,7,7,7,7,7,7,7,7,7,7,7,7,7,7,7,7,7,7],
    [7,6,6,6,6,6,6,6,6,6,6,6,6,6,6,6,6,6,6,6,6,6,6,6,6,6,6,6,6,6,6,6,6,6,7],
    [7,6,7,7,7,7,7,7,6,7,7,7,7,7,7,7,7,7,7,7,7,7,7,7,7,7,6,7,7,7,7,7,7,6,7],
    [7,6,7,6,6,6,6,6,6,6,6,6,6,6,6,6,6,6,6,6,6,6,6,6,6,6,6,6,6,6,6,6,7,6,7],
    [7,6,7,6,7,7,7,7,7,7,7,7,7,6,7,7,7,7,7,6,7,7,7,7,7,7,7,7,7,7,7,6,7,6,7],
    [7,6,6,6,6,6,6,6,6,6,6,6,6,6,6,6,6,6,6,6,6,6,6,6,6,6,6,6,6,6,6,6,6,6,7],
    [7,7,7,6,7,7,7,6,7,7,7,7,7,7,7,7,7,7,7,7,7,7,7,7,7,6,7,7,7,6,7,7,7,7,7],
    [7,6,6,6,6,6,6,6,6,6,6,6,6,6,6,6,6,6,6,6,6,6,6,6,6,6,6,6,6,6,6,6,6,6,7],
    [7,6,7,7,7,7,7,7,7,6,7,7,7,7,7,7,7,7,7,7,7,7,7,7,7,7,6,7,7,7,7,7,7,6,7],
    [7,6,6,6,6,6,6,6,6,6,6,6,6,6,6,6,6,6,6,6,6,6,6,6,6,6,6,6,6,6,6,6,6,6,7],
    [7,6,7,6,7,7,7,7,7,7,7,6,7,7,7,7,7,7,7,7,7,7,7,6,7,7,7,7,7,7,7,6,7,6,7],
    [7,6,7,6,6,6,6,6,6,6,6,6,6,6,6,6,6,6,6,6,6,6,6,6,6,6,6,6,6,6,6,6,7,6,7],
    [7,6,7,7,7,6,7,7,7,7,7,7,7,6,7,7,7,7,7,6,7,7,7,7,7,7,7,6,7,7,7,7,7,6,7],
    [7,6,6,6,6,6,6,6,6,6,6,6,6,6,6,6,6,6,6,6,6,6,6,6,6,6,6,6,6,6,6,6,6,6,7],
    [7,6,7,7,7,7,7,6,7,7,7,7,7,7,7,7,7,7,7,7,7,7,7,7,7,6,7,7,7,7,7,7,7,6,7],
    [7,6,6,6,6,6,6,6,6,6,6,6,6,6,6,6,6,6,6,6,6,6,6,6,6,6,6,6,6,6,6,6,6,6,7],
    [7,6,7,6,7,7,7,7,7,7,7,7,7,6,7,7,9,7,7,6,7,7,7,7,7,7,7,7,7,7,7,6,7,6,7],
    [7,6,7,6,6,6,6,6,6,6,6,6,6,6,6,6,6,6,6,6,6,6,6,6,6,6,6,6,6,6,6,6,7,6,7],
    [7,6,7,7,7,6,7,7,7,7,7,7,7,6,7,7,7,7,7,6,7,7,7,7,7,7,7,6,7,7,7,7,7,6,7],
    [7,6,6,6,6,6,6,6,6,6,6,6,6,6,6,6,6,6,6,6,6,6,6,6,6,6,6,6,6,6,6,6,6,6,7],
    [7,6,7,7,7,7,7,6,7,7,7,7,7,7,7,7,7,7,7,7,7,7,7,7,7,6,7,7,7,7,7,7,7,6,7],
    [7,6,6,6,6,6,6,6,6,6,6,6,6,6,6,6,6,6,6,6,6,6,6,6,6,6,6,6,6,6,6,6,6,6,7],
    [7,6,7,6,7,7,7,7,7,7,7,6,7,7,7,7,7,7,7,7,7,7,7,6,7,7,7,7,7,7,7,6,7,6,7],
    [7,6,7,6,6,6,6,6,6,6,6,6,6,6,6,6,6,6,6,6,6,6,6,6,6,6,6,6,6,6,6,6,7,6,7],
    [7,6,7,7,7,6,7,7,7,7,7,7,7,6,7,7,7,7,7,6,7,7,7,7,7,7,7,6,7,7,7,7,7,6,7],
    [7,6,6,6,6,6,6,6,6,6,6,6,6,6,6,6,6,6,6,6,6,6,6,6,6,6,6,6,6,6,6,6,6,6,7],
    [7,7,7,6,7,7,7,6,7,7,7,7,7,7,7,7,7,7,7,7,7,7,7,7,7,6,7,7,7,6,7,7,7,7,7],
    [7,6,6,6,6,6,6,6,6,6,6,6,6,6,6,6,6,6,6,6,6,6,6,6,6,6,6,6,6,6,6,6,6,6,7],
    [7,6,7,6,7,7,7,7,7,7,7,7,7,6,7,7,7,7,7,6,7,7,7,7,7,7,7,7,7,7,7,6,7,6,7],
    [7,6,7,6,6,6,6,6,6,6,6,6,6,6,6,6,6,6,6,6,6,6,6,6,6,6,6,6,6,6,6,6,7,6,7],
    [7,6,7,7,7,7,7,7,6,7,7,7,7,7,7,7,7,7,7,7,7,7,7,7,7,7,6,7,7,7,7,7,7,6,7],
    [7,6,6,6,6,6,6,6,6,6,6,6,6,6,6,6,6,6,6,6,6,6,6,6,6,6,6,6,6,6,6,6,6,6,7],
    [7,6,7,7,7,6,7,7,7,7,7,7,7,7,7,7,7,7,7,7,7,7,7,7,7,7,7,7,7,6,7,7,7,6,7],
    [7,6,6,6,6,6,6,6,6,6,6,6,6,6,6,6,10,6,6,6,6,6,6,6,6,6,6,6,6,6,6,6,6,6,7],
    [7,7,7,7,7,7,7,7,7,7,7,7,7,7,7,7,7,7,7,7,7,7,7,7,7,7,7,7,7,7,7,7,7,7,7]
  ],
  "warps": [
    { "x": 16, "y": 33, "targetMap": "maps/area3_castle_b1.json", "targetX": 14, "targetY": 13 },
    { "x": 16, "y": 16, "targetMap": "maps/area3_castle_2f.json", "targetX": 15, "targetY": 28 }
  ],
  "npcs": [
    {
      "id": "castle_1f_sage",
      "x": 5,
      "y": 17,
      "sprite": "🧙",
      "type": "villager",
      "messages": [
        "この城は、かつてセレスティア王国の中心だった...",
        "今は闇の影に支配されている。",
        "最奥に眠る者...それは敵ではない。",
        "救いを求めている者だ。"
      ]
    },
    {
      "id": "castle_1f_warning",
      "x": 29,
      "y": 17,
      "sprite": "👴",
      "type": "villager",
      "messages": [
        "2階には図書室がある。",
        "そこに強力な守護者がいると聞く...",
        "覚悟を決めて進むがよい。"
      ]
    }
  ],
  "chests": [
    { "id": "castle_1f_chest1", "x": 3, "y": 3, "itemId": 5, "isOpened": false },
    { "id": "castle_1f_chest2", "x": 31, "y": 3, "itemId": 9, "isOpened": false }
  ]
}
