{
  "mapId": "area3_castle_b1",
  "name": "古城セレスティア・地下1階",
  "type": "dungeon",
  "cols": 30,
  "rows": 30,
  "isSafe": false,
  "encounterRate": 0.09,
  "encounterTable": "castle_b1",
  "isOutdoor": false,
  "area": "area3",
  "isDesolated": true,
  "desolationLevel": 0.55,
  "data": [
    [7,7,7,7,7,7,7,7,7,7,7,7,7,7,7,7,7,7,7,7,7,7,7,7,7,7,7,7,7,7],
    [7,6,6,6,6,6,7,6,6,6,6,6,6,6,6,6,6,6,6,6,6,6,6,7,6,6,6,6,6,7],
    [7,6,7,7,7,6,7,6,7,7,7,7,7,7,7,7,7,7,7,7,7,7,6,7,6,7,7,7,6,7],
    [7,6,6,6,6,6,6,6,6,6,6,6,6,6,6,6,6,6,6,6,6,6,6,6,6,6,6,6,6,7],
    [7,7,7,6,7,7,7,7,7,7,6,7,7,7,7,7,7,7,7,6,7,7,7,7,7,7,6,7,7,7],
    [7,6,6,6,6,6,6,6,6,6,6,6,6,6,6,6,6,6,6,6,6,6,6,6,6,6,6,6,6,7],
    [7,6,7,7,7,6,7,7,7,7,7,6,7,7,7,7,7,6,7,7,7,7,7,6,7,7,7,7,6,7],
    [7,6,6,6,6,6,6,6,6,6,6,6,6,6,6,6,6,6,6,6,6,6,6,6,6,6,6,6,6,7],
    [7,6,7,6,7,7,7,6,7,7,7,7,7,7,7,7,7,7,7,7,6,7,7,7,6,7,6,7,6,7],
    [7,6,7,6,6,6,6,6,6,6,6,6,6,6,6,6,6,6,6,6,6,6,6,6,6,6,6,7,6,7],
    [7,6,7,7,7,6,7,7,7,6,7,7,7,7,7,7,7,7,6,7,7,7,7,6,7,7,7,7,6,7],
    [7,6,6,6,6,6,6,6,6,6,6,6,6,6,6,6,6,6,6,6,6,6,6,6,6,6,6,6,6,7],
    [7,6,7,6,7,7,7,7,7,7,7,6,7,7,7,7,7,6,7,7,7,7,7,7,7,7,6,7,6,7],
    [7,6,7,6,6,6,6,6,6,6,6,6,6,6,6,6,6,6,6,6,6,6,6,6,6,6,6,7,6,7],
    [7,6,7,7,7,6,7,7,7,6,7,7,7,7,9,7,7,7,7,6,7,7,7,6,7,7,7,7,6,7],
    [7,6,6,6,6,6,6,6,6,6,6,6,6,6,6,6,6,6,6,6,6,6,6,6,6,6,6,6,6,7],
    [7,6,7,6,7,7,7,7,7,7,7,6,7,7,7,7,7,6,7,7,7,7,7,7,7,7,6,7,6,7],
    [7,6,7,6,6,6,6,6,6,6,6,6,6,6,6,6,6,6,6,6,6,6,6,6,6,6,6,7,6,7],
    [7,6,7,7,7,6,7,7,7,6,7,7,7,7,7,7,7,7,6,7,7,7,7,6,7,7,7,7,6,7],
    [7,6,6,6,6,6,6,6,6,6,6,6,6,6,6,6,6,6,6,6,6,6,6,6,6,6,6,6,6,7],
    [7,6,7,6,7,7,7,6,7,7,7,7,7,7,7,7,7,7,7,7,6,7,7,7,6,7,6,7,6,7],
    [7,6,7,6,6,6,6,6,6,6,6,6,6,6,6,6,6,6,6,6,6,6,6,6,6,6,6,7,6,7],
    [7,6,7,7,7,6,7,7,7,7,7,6,7,7,7,7,7,6,7,7,7,7,7,6,7,7,7,7,6,7],
    [7,6,6,6,6,6,6,6,6,6,6,6,6,6,6,6,6,6,6,6,6,6,6,6,6,6,6,6,6,7],
    [7,7,7,6,7,7,7,7,7,7,6,7,7,7,7,7,7,7,7,6,7,7,7,7,7,7,6,7,7,7],
    [7,6,6,6,6,6,6,6,6,6,6,6,6,6,6,6,6,6,6,6,6,6,6,6,6,6,6,6,6,7],
    [7,6,7,7,7,6,7,6,7,7,7,7,7,7,7,7,7,7,7,7,7,7,6,7,6,7,7,7,6,7],
    [7,6,6,6,6,6,7,6,6,6,6,6,6,6,10,6,6,6,6,6,6,6,6,7,6,6,6,6,6,7],
    [7,6,6,6,6,6,6,6,6,6,6,6,6,6,6,6,6,6,6,6,6,6,6,6,6,6,6,6,6,7],
    [7,7,7,7,7,7,7,7,7,7,7,7,7,7,7,7,7,7,7,7,7,7,7,7,7,7,7,7,7,7]
  ],
  "warps": [
    { "x": 14, "y": 27, "targetMap": "maps/area3_castle_b2.json", "targetX": 14, "targetY": 13 },
    { "x": 14, "y": 14, "targetMap": "maps/area3_castle_1f.json", "targetX": 17, "targetY": 33 }
  ],
  "npcs": [
    {
      "id": "castle_b1_prisoner",
      "x": 25,
      "y": 10,
      "sprite": "👻",
      "type": "villager",
      "messages": [
        "...私はかつてこの城の騎士だった...",
        "闇に囚われ、100年...ここにいる...",
        "上階には隠し通路がある...気をつけろ..."
      ]
    }
  ],
  "chests": [
    { "id": "castle_b1_chest1", "x": 27, "y": 3, "itemId": 57, "isOpened": false }
  ]
}
