{
  "mapId": "area3_castle_3f",
  "name": "古城セレスティア・3階",
  "type": "dungeon",
  "cols": 25,
  "rows": 25,
  "isSafe": false,
  "encounterRate": 0.05,
  "encounterTable": "castle_3f",
  "isOutdoor": false,
  "area": "area3",
  "isDesolated": true,
  "desolationLevel": 0.4,
  "data": [
    [7,7,7,7,7,7,7,7,7,7,7,7,7,7,7,7,7,7,7,7,7,7,7,7,7],
    [7,6,6,6,6,6,6,6,6,6,6,6,6,6,6,6,6,6,6,6,6,6,6,6,7],
    [7,6,7,7,7,7,7,7,6,7,7,7,7,7,7,7,6,7,7,7,7,7,7,6,7],
    [7,6,7,6,6,6,6,6,6,6,6,6,6,6,6,6,6,6,6,6,6,6,7,6,7],
    [7,6,7,6,7,7,7,7,7,7,7,6,7,6,7,7,7,7,7,7,7,6,7,6,7],
    [7,6,6,6,6,6,6,6,6,6,6,6,6,6,6,6,6,6,6,6,6,6,6,6,7],
    [7,6,7,7,7,6,7,7,7,7,7,7,7,7,7,7,7,7,7,6,7,7,7,6,7],
    [7,6,6,6,6,6,6,6,6,6,6,6,6,6,6,6,6,6,6,6,6,6,6,6,7],
    [7,7,7,6,7,7,7,6,7,7,7,7,7,7,7,7,7,6,7,7,7,6,7,7,7],
    [7,6,6,6,6,6,6,6,6,6,6,6,6,6,6,6,6,6,6,6,6,6,6,6,7],
    [7,6,7,7,7,6,7,7,7,7,6,7,7,7,6,7,7,7,7,6,7,7,7,6,7],
    [7,6,6,6,6,6,6,6,6,6,6,6,6,6,6,6,6,6,6,6,6,6,6,6,7],
    [7,6,7,6,7,7,7,7,7,7,7,7,7,7,7,7,7,7,7,7,7,6,7,6,7],
    [7,6,7,6,6,6,6,6,6,6,6,6,6,6,6,6,6,6,6,6,6,6,7,6,7],
    [7,6,7,7,7,6,7,7,7,7,6,7,7,7,6,7,7,7,7,6,7,7,7,6,7],
    [7,6,6,6,6,6,6,6,6,6,6,6,6,6,6,6,6,6,6,6,6,6,6,6,7],
    [7,7,7,6,7,7,7,6,7,7,7,7,7,7,7,7,7,6,7,7,7,6,7,7,7],
    [7,6,6,6,6,6,6,6,6,6,6,6,6,6,6,6,6,6,6,6,6,6,6,6,7],
    [7,6,7,7,7,6,7,7,7,7,7,7,7,7,7,7,7,7,7,6,7,7,7,6,7],
    [7,6,6,6,6,6,6,6,6,6,6,6,6,6,6,6,6,6,6,6,6,6,6,6,7],
    [7,6,7,6,7,7,7,7,7,7,7,6,7,6,7,7,7,7,7,7,7,6,7,6,7],
    [7,6,7,6,6,6,6,6,6,6,6,6,6,6,6,6,6,6,6,6,6,6,7,6,7],
    [7,6,7,7,7,7,7,7,6,7,7,7,7,7,7,7,6,7,7,7,7,7,7,6,7],
    [7,6,6,6,6,6,6,6,6,6,6,6,9,6,6,6,6,6,6,6,6,6,6,6,7],
    [7,7,7,7,7,7,7,7,7,7,7,7,7,7,7,7,7,7,7,7,7,7,7,7,7]
  ],
  "warps": [
    { "x": 12, "y": 23, "targetMap": "maps/area3_castle_2f.json", "targetX": 14, "targetY": 13 }
  ],
  "npcs": [
    {
      "id": "ancient_guardian",
      "x": 12,
      "y": 2,
      "sprite": "👁️",
      "type": "boss",
      "bossId": "shadowGuardian",
      "requiresFlag": "ancientCastleUnlocked",
      "messages": [
        "......",
        "...来たか。星に導かれし者よ。",
        "我は...光の守護者...だった者。",
        "この闇が...我を蝕む...",
        "100年...ずっと苦しんできた...",
        "頼む...終わらせてくれ...",
        "だが...我にもまだ力がある...",
        "お前たちが本当に救えるかどうか...",
        "この戦いで証明してみせろ！"
      ],
      "defeatedMessages": [
        "......",
        "...ありがとう...",
        "ようやく...光が見える...",
        "長い闇の時代が...終わる...",
        "我の核にある光を...解放してくれ...",
        "そうすれば...この地に星の光が戻る..."
      ]
    }
  ],
  "chests": []
}
