{
  "mapId": "area3_castle_2f",
  "name": "古城セレスティア・2階",
  "type": "dungeon",
  "cols": 30,
  "rows": 30,
  "isSafe": false,
  "encounterRate": 0.1,
  "encounterTable": "castle_2f",
  "isOutdoor": false,
  "area": "area3",
  "isDesolated": true,
  "desolationLevel": 0.45,
  "data": [
    [7,7,7,7,7,7,7,7,7,7,7,7,7,7,7,7,7,7,7,7,7,7,7,7,7,7,7,7,7,7],
    [7,6,6,6,6,6,6,6,6,6,6,6,6,6,6,6,6,6,6,6,6,6,6,6,6,6,6,6,6,7],
    [7,6,7,7,7,7,7,7,7,6,7,7,7,7,7,7,7,7,7,7,6,7,7,7,7,7,7,7,6,7],
    [7,6,7,6,6,6,6,6,6,6,6,6,6,6,6,6,6,6,6,6,6,6,6,6,6,6,6,7,6,7],
    [7,6,7,6,7,7,7,7,7,7,7,7,7,6,7,7,6,7,7,7,7,7,7,7,7,7,6,7,6,7],
    [7,6,6,6,6,6,6,6,6,6,6,6,6,6,6,6,6,6,6,6,6,6,6,6,6,6,6,6,6,7],
    [7,7,7,6,7,7,7,6,7,7,7,7,7,7,7,7,7,7,7,7,6,7,7,7,6,7,7,7,7,7],
    [7,6,6,6,6,6,6,6,6,6,6,6,6,6,6,6,6,6,6,6,6,6,6,6,6,6,6,6,6,7],
    [7,6,7,7,7,7,7,7,7,6,7,7,7,7,7,7,7,7,7,7,6,7,7,7,7,7,7,7,6,7],
    [7,6,6,6,6,6,6,6,6,6,6,6,6,6,6,6,6,6,6,6,6,6,6,6,6,6,6,6,6,7],
    [7,6,7,6,7,7,7,7,7,7,7,6,7,7,7,7,7,7,6,7,7,7,7,7,7,7,6,7,6,7],
    [7,6,7,6,6,6,6,6,6,6,6,6,6,6,6,6,6,6,6,6,6,6,6,6,6,6,6,7,6,7],
    [7,6,7,7,7,7,7,6,7,7,7,7,7,6,7,7,6,7,7,7,7,7,6,7,7,7,7,7,6,7],
    [7,6,6,6,6,6,6,6,6,6,6,6,6,6,6,6,6,6,6,6,6,6,6,6,6,6,6,6,6,7],
    [7,6,7,7,7,6,7,7,7,7,7,7,7,7,9,7,7,7,7,7,7,7,7,6,7,7,7,7,6,7],
    [7,6,6,6,6,6,6,6,6,6,6,6,6,6,6,6,6,6,6,6,6,6,6,6,6,6,6,6,6,7],
    [7,6,7,7,7,7,7,6,7,7,7,7,7,6,7,7,6,7,7,7,7,7,6,7,7,7,7,7,6,7],
    [7,6,7,6,6,6,6,6,6,6,6,6,6,6,6,6,6,6,6,6,6,6,6,6,6,6,6,7,6,7],
    [7,6,7,6,7,7,7,7,7,7,7,6,7,7,7,7,7,7,6,7,7,7,7,7,7,7,6,7,6,7],
    [7,6,6,6,6,6,6,6,6,6,6,6,6,6,6,6,6,6,6,6,6,6,6,6,6,6,6,6,6,7],
    [7,6,7,7,7,7,7,7,7,6,7,7,7,7,7,7,7,7,7,7,6,7,7,7,7,7,7,7,6,7],
    [7,6,6,6,6,6,6,6,6,6,6,6,6,6,6,6,6,6,6,6,6,6,6,6,6,6,6,6,6,7],
    [7,7,7,6,7,7,7,6,7,7,7,7,7,7,7,7,7,7,7,7,6,7,7,7,6,7,7,7,7,7],
    [7,6,6,6,6,6,6,6,6,6,6,6,6,6,6,6,6,6,6,6,6,6,6,6,6,6,6,6,6,7],
    [7,6,7,6,7,7,7,7,7,7,7,7,7,6,7,7,6,7,7,7,7,7,7,7,7,7,6,7,6,7],
    [7,6,7,6,6,6,6,6,6,6,6,6,6,6,6,6,6,6,6,6,6,6,6,6,6,6,6,7,6,7],
    [7,6,7,7,7,7,7,7,7,6,7,7,7,7,7,7,7,7,7,7,6,7,7,7,7,7,7,7,6,7],
    [7,6,6,6,6,6,6,6,6,6,6,6,6,6,10,6,6,6,6,6,6,6,6,6,6,6,6,6,6,7],
    [7,6,6,6,6,6,6,6,6,6,6,6,6,6,6,6,6,6,6,6,6,6,6,6,6,6,6,6,6,7],
    [7,7,7,7,7,7,7,7,7,7,7,7,7,7,7,7,7,7,7,7,7,7,7,7,7,7,7,7,7,7]
  ],
  "warps": [
    { "x": 14, "y": 27, "targetMap": "maps/area3_castle_1f.json", "targetX": 16, "targetY": 15 },
    { "x": 14, "y": 14, "targetMap": "maps/area3_castle_3f.json", "targetX": 12, "targetY": 23 }
  ],
  "npcs": [
    {
      "id": "library_guardian",
      "x": 15,
      "y": 5,
      "sprite": "📚",
      "type": "boss",
      "bossId": "libraryGuardian",
      "messages": [
        "この図書室には...王国の秘密が眠っている。",
        "それを守るのが...我が使命。",
        "たとえ100年経とうとも...誰も通さぬ！"
      ],
      "defeatedMessages": [
        "...我が使命は...果たされた...",
        "お前たちなら...王を救えるやもしれぬ...",
        "先へ進め..."
      ]
    }
  ],
  "chests": [
    { "id": "castle_2f_chest1", "x": 3, "y": 25, "itemId": 58, "isOpened": false }
  ]
}
