{
  "mapId": "coral_beach",
  "name": "珊瑚の浜",
  "cols": 40,
  "rows": 30,
  "tileSize": 32,
  "isOutdoor": true,
  "data": [
    2,2,2,2,2,2,2,2,2,2,2,2,2,2,2,2,2,2,2,2,2,2,2,2,2,2,2,2,2,2,2,2,2,2,2,2,2,2,2,2,
    2,2,2,2,2,2,2,2,2,2,2,2,2,2,2,2,2,2,2,2,2,2,2,2,2,2,2,2,2,2,2,2,2,2,2,2,2,2,2,2,
    2,2,2,2,2,2,2,2,2,2,2,2,2,2,2,2,2,2,2,2,2,2,2,2,2,2,2,2,2,2,2,2,2,2,2,2,2,2,2,2,
    33,33,33,33,33,33,33,33,33,33,33,33,33,33,33,33,33,33,33,30,33,33,33,33,33,33,33,33,33,33,33,33,33,33,33,33,33,33,33,33,
    33,33,33,33,33,33,33,33,33,33,33,33,33,33,33,33,33,33,33,6,33,33,33,33,33,33,33,33,33,33,33,33,33,33,33,33,33,33,33,33,
    0,0,0,0,0,0,0,0,0,0,0,0,0,0,0,0,0,0,0,6,0,0,0,0,0,0,0,0,0,0,0,0,0,0,0,0,0,0,0,0,
    0,0,0,0,0,0,0,0,0,0,0,0,0,0,0,0,0,0,0,6,0,0,0,0,0,0,0,0,0,0,0,0,0,0,0,0,0,0,0,0,
    0,0,0,0,0,7,7,7,7,0,0,0,0,0,0,0,0,0,0,6,0,0,0,0,0,0,0,0,0,7,7,7,0,0,0,0,0,0,0,0,
    0,0,0,0,0,7,6,6,7,0,0,0,0,0,0,0,0,0,6,6,6,0,0,0,0,0,0,0,0,7,6,7,0,0,0,0,0,0,0,0,
    0,0,0,0,0,7,6,6,7,0,0,0,0,0,0,0,0,0,6,6,6,0,0,0,0,0,0,0,0,7,6,7,0,0,0,0,0,0,0,0,
    0,0,0,0,0,7,7,6,7,0,0,0,0,0,0,0,0,6,6,0,6,6,0,0,0,0,0,0,0,7,6,7,7,0,0,0,0,0,0,0,
    0,0,0,0,0,0,0,6,0,0,0,0,0,0,0,0,6,6,0,0,0,6,6,0,0,0,0,0,0,7,6,6,7,0,0,0,0,0,0,0,
    0,0,0,0,0,0,0,6,0,0,0,0,0,0,0,6,6,0,0,0,0,0,6,6,0,0,0,0,0,7,7,6,7,0,0,0,0,0,0,0,
    0,0,0,0,0,0,6,6,6,0,0,0,0,0,6,6,0,0,0,0,0,0,0,6,6,0,0,0,0,0,0,6,0,0,0,0,0,0,0,0,
    0,0,0,0,0,6,6,0,6,6,0,0,0,0,6,0,0,0,0,0,0,0,0,0,6,0,0,0,0,0,0,6,0,0,0,0,0,0,0,0,
    0,0,0,0,6,6,0,0,0,6,6,0,0,6,6,0,0,0,0,0,0,0,0,0,6,6,0,0,0,0,6,6,6,0,0,0,0,0,0,0,
    0,0,0,6,6,0,0,0,0,0,6,6,6,6,0,0,0,0,0,0,0,0,0,0,0,6,6,0,0,6,6,0,6,6,0,0,0,0,0,0,
    0,0,6,6,0,0,0,0,0,0,0,6,6,0,0,0,0,0,0,0,0,0,0,0,0,0,6,6,6,6,0,0,0,6,6,0,0,0,0,0,
    0,6,6,0,0,0,0,0,0,0,0,6,6,0,0,0,0,0,0,0,0,0,0,0,0,0,0,6,6,0,0,0,0,0,6,6,0,0,0,0,
    6,6,0,0,0,0,0,0,0,0,0,6,6,0,0,0,0,0,0,0,0,0,0,0,0,0,0,6,6,0,0,0,0,0,0,6,6,0,0,0,
    6,6,6,6,0,0,0,0,0,0,6,6,6,0,0,0,0,0,0,0,0,0,0,0,0,0,0,6,6,0,0,0,0,0,0,0,6,6,6,6,
    0,0,0,6,6,6,6,6,6,6,6,0,6,6,0,0,0,0,0,0,0,0,0,0,0,0,6,6,6,6,0,0,0,0,0,0,0,0,0,0,
    0,0,0,0,0,0,0,0,0,0,0,0,0,6,6,0,0,0,0,0,0,0,0,0,0,6,6,0,0,6,6,6,6,6,6,6,6,0,0,0,
    0,0,0,0,0,0,0,0,0,0,0,0,0,0,6,6,0,0,0,0,0,0,0,0,6,6,0,0,0,0,0,0,0,0,0,0,6,6,0,0,
    0,0,0,0,0,0,0,0,0,0,0,0,0,0,0,6,6,6,0,0,0,0,0,6,6,0,0,0,0,0,0,0,0,0,0,0,0,6,6,0,
    0,0,0,0,0,0,0,0,0,0,0,0,0,0,0,0,0,6,6,6,6,6,6,6,0,0,0,0,0,0,0,0,0,0,0,0,0,0,6,0,
    0,0,0,0,0,0,0,0,0,0,0,0,0,0,0,0,0,0,0,0,0,0,0,0,0,0,0,0,0,0,0,0,0,0,0,0,0,0,6,6,
    0,0,0,0,0,0,0,0,0,0,0,0,0,0,0,0,0,0,0,0,0,0,0,0,0,0,0,0,0,0,0,0,0,0,0,0,0,0,0,0,
    0,0,0,0,0,0,0,0,0,0,0,0,0,0,0,0,0,0,0,0,0,0,0,0,0,0,0,0,0,0,0,0,0,0,0,0,0,0,0,0,
    0,0,0,0,0,0,0,0,0,0,0,0,0,0,0,0,0,0,0,0,0,0,0,0,0,0,0,0,0,0,0,0,0,0,0,0,0,0,0,0
  ],
  "warps": [
    {"x": 19, "y": 3, "targetMap": "maps/area5_ocean.json", "targetX": 45, "targetY": 35, "type": "embark"},
    {"x": 6, "y": 9, "targetMap": "maps/coral_village.json", "targetX": 10, "targetY": 18},
    {"x": 30, "y": 10, "targetMap": "maps/coral_maze.json", "targetX": 10, "targetY": 28}
  ],
  "npcs": [
    {"id": "beach_fisherman", "x": 15, "y": 12, "sprite": "🎣", "type": "villager", "messages": ["ここの魚は一味違うぜ。", "珊瑚礁には珍しい生き物がたくさんいる。"]},
    {"id": "beach_hermit", "x": 25, "y": 18, "sprite": "🧓", "type": "villager", "messages": ["この浜辺に隠された洞窟があるという噂じゃ..."]},
    {"id": "beach_crab", "x": 8, "y": 22, "sprite": "🦀", "type": "villager", "messages": ["カニカニ..."]}
  ],
  "chests": [
    {"id": "beach_chest1", "x": 35, "y": 6, "itemId": 2, "itemName": "やくそう", "isOpened": false},
    {"id": "beach_chest2", "x": 3, "y": 25, "itemId": 121, "itemName": "人魚の涙", "isOpened": false}
  ],
  "encounterTable": "area5_coral_beach",
  "encounterRate": 0.06
}
