{
  "mapId": "dungeon",
  "name": "暗黒の洞窟",
  "type": "dungeon",
  "cols": 25,
  "rows": 25,
  "isSafe": false,
  "encounterRate": 0.12,
  "data": [
    [7,7,7,7,7,7,7,7,7,7,7,7,7,7,7,7,7,7,7,7,7,7,7,7,7],
    [7,5,6,6,6,6,6,6,6,6,6,6,6,6,6,6,6,6,6,6,6,6,6,6,7],
    [7,6,6,7,7,7,6,6,7,7,7,7,7,6,6,7,7,7,6,6,7,7,6,6,7],
    [7,6,6,7,6,6,6,6,6,6,6,6,7,6,6,7,6,6,6,6,6,7,6,6,7],
    [7,6,6,7,6,7,7,7,7,7,6,6,7,6,6,7,6,7,7,7,6,7,6,6,7],
    [7,6,6,6,6,6,6,6,6,7,6,6,6,6,6,6,6,6,6,7,6,6,6,6,7],
    [7,7,7,7,7,7,6,6,6,7,6,7,7,7,7,7,7,6,6,7,6,7,7,7,7],
    [7,6,6,6,6,6,6,6,6,6,6,6,6,6,6,6,6,6,6,6,6,6,6,6,7],
    [7,6,7,7,7,7,6,7,7,7,7,7,6,7,7,7,7,7,6,7,7,7,7,6,7],
    [7,6,6,6,6,6,6,6,6,6,6,6,6,6,6,6,6,6,6,6,6,6,6,6,7],
    [7,6,6,7,7,7,7,7,6,7,7,7,7,7,6,7,7,7,7,7,6,7,7,6,7],
    [7,6,6,6,6,6,6,6,6,6,6,6,6,6,6,6,6,6,6,6,6,6,6,6,7],
    [7,7,7,7,6,7,7,7,7,7,6,7,7,7,6,7,7,7,7,7,6,7,7,7,7],
    [7,6,6,6,6,6,6,6,6,6,6,6,6,6,6,6,6,6,6,6,6,6,6,6,7],
    [7,6,7,7,7,7,6,7,7,7,7,7,6,7,7,7,7,7,6,7,7,7,7,6,7],
    [7,6,6,6,6,6,6,6,6,6,6,6,6,6,6,6,6,6,6,6,6,6,6,6,7],
    [7,6,6,7,7,7,7,7,6,7,7,7,7,7,6,7,7,7,7,7,6,7,7,6,7],
    [7,6,6,6,6,6,6,6,6,6,6,6,6,6,6,6,6,6,6,6,6,6,6,6,7],
    [7,7,7,7,6,7,7,7,7,7,6,7,7,7,6,7,7,7,7,7,6,7,7,7,7],
    [7,6,6,6,6,6,6,6,6,6,6,6,6,6,6,6,6,6,6,6,6,6,6,6,7],
    [7,6,7,7,7,7,6,7,7,7,7,7,6,7,7,7,7,7,6,7,7,7,7,6,7],
    [7,6,6,6,6,6,6,6,6,6,6,6,6,6,6,6,6,6,6,6,6,6,6,6,7],
    [7,6,6,6,6,6,6,6,6,6,6,6,6,6,6,6,6,6,6,6,6,6,6,5,7],
    [7,6,6,6,6,6,6,6,6,6,6,6,6,6,6,6,6,6,6,6,6,6,6,6,7],
    [7,7,7,7,7,7,7,7,7,7,7,7,7,7,7,7,7,7,7,7,7,7,7,7,7]
  ],
  "warps": [
    { "x": 1, "y": 1, "targetMap": "maps/field.json", "targetX": 39, "targetY": 11 },
    { "x": 23, "y": 22, "targetMap": "maps/maou_room.json", "targetX": 7, "targetY": 12 }
  ],
  "npcs": [
    { "id": "hermit", "x": 12, "y": 12, "sprite": "🧙", "type": "hermit", "messages": ["ほほう、ここまで来たか。", "わしは昔、勇者だった。", "この奥に魔王がいる。", "心して進むがよい。", "伝説の剣があれば勝てるかもしれん。"] }
  ],
  "chests": [
    { "id": "dungeon_chest1", "x": 4, "y": 3, "itemId": 1, "isOpened": false },
    { "id": "dungeon_chest2", "x": 20, "y": 10, "itemId": 14, "isOpened": false },
    { "id": "dungeon_chest3", "x": 5, "y": 20, "itemId": 1, "isOpened": false }
  ]
}
