{
  "mapId": "ice_temple_boss",
  "name": "氷の神殿・竜の間",
  "type": "dungeon",
  "cols": 20,
  "rows": 20,
  "isSafe": false,
  "encounterRate": 0,
  "isOutdoor": false,
  "area": "area4",
  "data": [
    [6, 6, 6, 6, 6, 6, 6, 6, 6, 6, 6, 6, 6, 6, 6, 6, 6, 6, 6, 6],
    [6, 21, 21, 21, 21, 21, 21, 21, 21, 21, 21, 21, 21, 21, 21, 21, 21, 21, 21, 6],
    [6, 21, 21, 21, 21, 21, 21, 21, 21, 21, 21, 21, 21, 21, 21, 21, 21, 21, 21, 6],
    [6, 21, 21, 6, 6, 6, 21, 21, 21, 21, 21, 21, 21, 21, 6, 6, 6, 21, 21, 6],
    [6, 21, 21, 6, 24, 24, 24, 24, 24, 24, 24, 24, 24, 24, 24, 24, 6, 21, 21, 6],
    [6, 21, 21, 6, 24, 24, 24, 24, 24, 24, 24, 24, 24, 24, 24, 24, 6, 21, 21, 6],
    [6, 21, 21, 21, 24, 24, 24, 24, 24, 24, 24, 24, 24, 24, 24, 24, 21, 21, 21, 6],
    [6, 21, 21, 21, 24, 24, 24, 24, 24, 24, 24, 24, 24, 24, 24, 24, 21, 21, 21, 6],
    [6, 21, 21, 21, 24, 24, 24, 24, 24, 24, 24, 24, 24, 24, 24, 24, 21, 21, 21, 6],
    [6, 21, 21, 21, 24, 24, 24, 24, 24, 24, 24, 24, 24, 24, 24, 24, 21, 21, 21, 6],
    [6, 21, 21, 21, 24, 24, 24, 24, 24, 24, 24, 24, 24, 24, 24, 24, 21, 21, 21, 6],
    [6, 21, 21, 21, 24, 24, 24, 24, 24, 24, 24, 24, 24, 24, 24, 24, 21, 21, 21, 6],
    [6, 21, 21, 6, 24, 24, 24, 24, 24, 24, 24, 24, 24, 24, 24, 24, 6, 21, 21, 6],
    [6, 21, 21, 6, 24, 24, 24, 24, 24, 24, 24, 24, 24, 24, 24, 24, 6, 21, 21, 6],
    [6, 21, 21, 6, 6, 6, 21, 21, 21, 24, 24, 21, 21, 21, 6, 6, 6, 21, 21, 6],
    [6, 21, 21, 21, 21, 21, 21, 21, 21, 24, 24, 21, 21, 21, 21, 21, 21, 21, 21, 6],
    [6, 21, 21, 21, 21, 21, 21, 21, 21, 24, 24, 21, 21, 21, 21, 21, 21, 21, 21, 6],
    [6, 21, 21, 21, 21, 21, 21, 21, 21, 24, 24, 21, 21, 21, 21, 21, 21, 21, 21, 6],
    [6, 21, 21, 21, 21, 21, 21, 21, 21, 24, 24, 21, 21, 21, 21, 21, 21, 21, 21, 6],
    [6, 6, 6, 6, 6, 6, 6, 6, 6, 24, 24, 6, 6, 6, 6, 6, 6, 6, 6, 6]
  ],
  "warps": [
    {
      "x": 9,
      "y": 19,
      "targetMap": "maps/ice_temple_3f.json",
      "targetX": 10,
      "targetY": 4
    },
    {
      "x": 10,
      "y": 19,
      "targetMap": "maps/ice_temple_3f.json",
      "targetX": 10,
      "targetY": 4
    }
  ],
  "npcs": [
    {
      "id": "frost_wyrm",
      "name": "氷龍フロストヴルム",
      "sprite": "🐲",
      "x": 9,
      "y": 6,
      "direction": "down",
      "isBoss": true,
      "bossId": "frostWyrm",
      "defeatFlag": "frostWyrmDefeated",
      "dialog": [
        "グオオオオ...！",
        "この神殿に足を踏み入れた愚か者よ...",
        "永久の氷の中で眠るがいい！"
      ]
    }
  ],
  "chests": [
    {
      "id": "boss_chest1",
      "x": 5,
      "y": 5,
      "itemId": 85,
      "gold": 0
    },
    {
      "id": "boss_chest2",
      "x": 14,
      "y": 5,
      "gold": 3000
    }
  ]
}
