{
  "mapId": "maouRoom",
  "name": "魔王の間",
  "type": "dungeon",
  "cols": 15,
  "rows": 15,
  "encounterRate": 0,
  "data": [
    [7,7,7,7,7,7,7,7,7,7,7,7,7,7,7],
    [7,6,6,6,6,6,6,6,6,6,6,6,6,6,7],
    [7,6,6,6,6,6,6,6,6,6,6,6,6,6,7],
    [7,6,6,6,6,6,6,6,6,6,6,6,6,6,7],
    [7,6,6,6,6,6,6,6,6,6,6,6,6,6,7],
    [7,6,6,6,6,6,6,6,6,6,6,6,6,6,7],
    [7,6,6,6,6,6,6,6,6,6,6,6,6,6,7],
    [7,6,6,6,6,6,6,6,6,6,6,6,6,6,7],
    [7,6,6,6,6,6,6,6,6,6,6,6,6,6,7],
    [7,6,6,6,6,6,6,6,6,6,6,6,6,6,7],
    [7,6,6,6,6,6,6,6,6,6,6,6,6,6,7],
    [7,6,6,6,6,6,6,6,6,6,6,6,6,6,7],
    [7,6,6,6,6,6,6,5,6,6,6,6,6,6,7],
    [7,6,6,6,6,6,6,6,6,6,6,6,6,6,7],
    [7,7,7,7,7,7,7,7,7,7,7,7,7,7,7]
  ],
  "warps": [
    { "x": 7, "y": 12, "targetMap": "maps/dungeon.json", "targetX": 23, "targetY": 21 }
  ],
  "npcs": [
    { "id": "maou", "x": 7, "y": 3, "sprite": "👿", "type": "maou", "messages": [] }
  ],
  "chests": []
}
