{
  "mapId": "ocean_floor",
  "name": "深海の底",
  "cols": 40,
  "rows": 35,
  "tileSize": 32,
  "isOutdoor": true,
  "isUnderwater": true,
  "data": [
    31,31,31,31,31,31,31,31,31,31,31,31,31,31,31,31,31,31,31,31,31,31,31,31,31,31,31,31,31,31,31,31,31,31,31,31,31,31,31,31,
    31,31,31,31,31,31,31,31,31,31,31,31,31,31,31,31,31,31,31,31,31,31,31,31,31,31,31,31,31,31,31,31,31,31,31,31,31,31,31,31,
    31,31,31,31,31,31,31,31,31,31,31,31,31,31,31,31,31,31,31,30,31,31,31,31,31,31,31,31,31,31,31,31,31,31,31,31,31,31,31,31,
    31,31,31,31,31,31,31,31,31,31,31,31,31,31,31,31,31,31,31,6,31,31,31,31,31,31,31,31,31,31,31,31,31,31,31,31,31,31,31,31,
    31,31,31,31,6,6,6,6,6,6,6,6,6,6,6,6,6,6,6,6,6,6,6,6,6,6,6,6,6,6,6,6,6,6,31,31,31,31,31,31,
    31,31,31,6,6,6,6,6,6,6,6,6,6,6,6,6,6,6,6,6,6,6,6,6,6,6,6,6,6,6,6,6,6,6,6,31,31,31,31,31,
    31,31,6,6,6,6,6,36,36,6,6,6,6,6,6,6,6,6,6,6,6,6,6,6,6,6,6,6,6,36,36,6,6,6,6,6,31,31,31,31,
    31,31,6,6,6,6,36,36,36,36,6,6,6,6,6,6,6,6,6,6,6,6,6,6,6,6,6,6,36,36,36,36,6,6,6,6,31,31,31,31,
    31,31,6,6,6,6,6,36,36,6,6,6,6,6,6,6,6,6,6,6,6,6,6,6,6,6,6,6,6,36,36,6,6,6,6,6,31,31,31,31,
    31,31,6,6,6,6,6,6,6,6,6,6,6,6,6,6,6,6,41,41,41,6,6,6,6,6,6,6,6,6,6,6,6,6,6,6,31,31,31,31,
    31,31,6,6,6,6,6,6,6,6,6,6,6,6,6,6,6,41,41,41,41,41,6,6,6,6,6,6,6,6,6,6,6,6,6,6,31,31,31,31,
    31,31,6,6,6,6,6,6,6,6,6,6,6,6,6,6,6,41,41,6,41,41,6,6,6,6,6,6,6,6,6,6,6,6,6,6,31,31,31,31,
    31,31,6,6,6,6,6,6,6,6,6,6,6,6,6,6,6,6,6,6,6,6,6,6,6,6,6,6,6,6,6,6,6,6,6,6,31,31,31,31,
    31,31,6,6,6,6,6,6,6,6,6,6,6,6,6,6,6,6,6,6,6,6,6,6,6,6,6,6,6,6,6,6,6,6,6,6,31,31,31,31,
    31,31,6,6,6,6,6,6,6,6,6,6,38,38,38,6,6,6,6,6,6,6,6,6,6,38,38,38,6,6,6,6,6,6,6,6,31,31,31,31,
    31,31,6,6,6,6,6,6,6,6,6,38,38,38,38,38,6,6,6,6,6,6,6,38,38,38,38,38,6,6,6,6,6,6,6,6,31,31,31,31,
    31,31,6,6,6,6,6,6,6,6,6,38,38,6,38,38,6,6,6,6,6,6,6,38,38,6,38,38,6,6,6,6,6,6,6,6,31,31,31,31,
    31,31,6,6,6,6,6,6,6,6,6,6,6,6,6,6,6,6,6,6,6,6,6,6,6,6,6,6,6,6,6,6,6,6,6,6,31,31,31,31,
    31,31,6,6,6,6,6,6,6,6,6,6,6,6,6,6,6,6,6,6,6,6,6,6,6,6,6,6,6,6,6,6,6,6,6,6,31,31,31,31,
    31,31,6,6,6,6,6,6,6,6,6,6,6,6,7,7,7,7,7,6,7,7,7,7,7,6,6,6,6,6,6,6,6,6,6,6,31,31,31,31,
    31,31,6,6,6,6,6,6,6,6,6,6,6,6,7,6,6,6,6,6,6,6,6,6,7,6,6,6,6,6,6,6,6,6,6,6,31,31,31,31,
    31,31,6,6,6,6,6,6,6,6,6,6,6,6,7,6,6,6,6,6,6,6,6,6,7,6,6,6,6,6,6,6,6,6,6,6,31,31,31,31,
    31,31,6,6,6,6,6,6,6,6,6,6,6,6,7,6,6,6,6,6,6,6,6,6,7,6,6,6,6,6,6,6,6,6,6,6,31,31,31,31,
    31,31,6,6,6,6,6,6,6,6,6,6,6,6,7,6,6,6,6,6,6,6,6,6,7,6,6,6,6,6,6,6,6,6,6,6,31,31,31,31,
    31,31,6,6,6,6,6,6,6,6,6,6,6,6,7,6,6,6,6,6,6,6,6,6,7,6,6,6,6,6,6,6,6,6,6,6,31,31,31,31,
    31,31,6,6,6,6,6,6,6,6,6,6,6,6,7,7,7,7,6,6,7,7,7,7,7,6,6,6,6,6,6,6,6,6,6,6,31,31,31,31,
    31,31,31,6,6,6,6,6,6,6,6,6,6,6,6,6,6,6,6,6,6,6,6,6,6,6,6,6,6,6,6,6,6,6,6,31,31,31,31,31,
    31,31,31,31,6,6,6,6,6,6,6,6,6,6,6,6,6,6,6,6,6,6,6,6,6,6,6,6,6,6,6,6,6,6,31,31,31,31,31,31,
    31,31,31,31,31,6,6,6,6,6,6,6,6,6,6,6,6,6,6,6,6,6,6,6,6,6,6,6,6,6,6,6,6,31,31,31,31,31,31,31,
    31,31,31,31,31,31,31,31,31,31,31,31,31,31,31,31,31,31,31,31,31,31,31,31,31,31,31,31,31,31,31,31,31,31,31,31,31,31,31,31,
    31,31,31,31,31,31,31,31,31,31,31,31,31,31,31,31,31,31,31,31,31,31,31,31,31,31,31,31,31,31,31,31,31,31,31,31,31,31,31,31,
    31,31,31,31,31,31,31,31,31,31,31,31,31,31,31,31,31,31,31,31,31,31,31,31,31,31,31,31,31,31,31,31,31,31,31,31,31,31,31,31,
    31,31,31,31,31,31,31,31,31,31,31,31,31,31,31,31,31,31,31,31,31,31,31,31,31,31,31,31,31,31,31,31,31,31,31,31,31,31,31,31,
    31,31,31,31,31,31,31,31,31,31,31,31,31,31,31,31,31,31,31,31,31,31,31,31,31,31,31,31,31,31,31,31,31,31,31,31,31,31,31,31,
    31,31,31,31,31,31,31,31,31,31,31,31,31,31,31,31,31,31,31,31,31,31,31,31,31,31,31,31,31,31,31,31,31,31,31,31,31,31,31,31
  ],
  "warps": [
    {"x": 19, "y": 2, "targetMap": "maps/area5_ocean.json", "targetX": 100, "targetY": 150, "type": "embark"},
    {"x": 19, "y": 25, "targetMap": "maps/siren_palace.json", "targetX": 10, "targetY": 19}
  ],
  "npcs": [
    {"id": "deep_mermaid", "x": 19, "y": 10, "sprite": "🧜‍♀️", "type": "villager", "messages": ["ここは深海の底...", "セイレーン様の宮殿はすぐそこよ。"]},
    {"id": "ancient_fish", "x": 10, "y": 15, "sprite": "🐟", "type": "villager", "messages": ["この海には古代の秘密が眠っている..."]}
  ],
  "chests": [
    {"id": "ocean_floor_chest1", "x": 7, "y": 7, "itemId": 141, "itemName": "青い涙", "isOpened": false},
    {"id": "ocean_floor_chest2", "x": 30, "y": 7, "itemId": 4, "itemName": "まんげつ草", "isOpened": false}
  ],
  "encounterTable": "area5_ocean_floor",
  "encounterRate": 0.08
}
