{
  "mapId": "prison_exterior",
  "name": "監獄島外周",
  "cols": 35,
  "rows": 35,
  "tileSize": 32,
  "isOutdoor": true,
  "data": [
    2,2,2,2,2,2,2,2,2,2,2,2,2,2,2,2,2,30,2,2,2,2,2,2,2,2,2,2,2,2,2,2,2,2,2,
    2,2,2,2,2,2,2,2,2,2,2,2,2,2,2,2,2,6,2,2,2,2,2,2,2,2,2,2,2,2,2,2,2,2,2,
    2,2,7,7,7,7,7,7,7,7,7,7,7,7,7,7,7,6,7,7,7,7,7,7,7,7,7,7,7,7,7,7,7,2,2,
    2,2,7,6,6,6,6,6,6,6,6,6,6,6,6,6,6,6,6,6,6,6,6,6,6,6,6,6,6,6,6,6,7,2,2,
    2,2,7,6,6,6,6,6,6,6,6,6,6,6,6,6,6,6,6,6,6,6,6,6,6,6,6,6,6,6,6,6,7,2,2,
    2,2,7,6,6,7,7,7,7,7,7,7,7,7,7,7,7,6,7,7,7,7,7,7,7,7,7,7,7,7,6,6,7,2,2,
    2,2,7,6,6,7,7,7,7,7,7,7,7,7,7,7,7,6,7,7,7,7,7,7,7,7,7,7,7,7,6,6,7,2,2,
    2,2,7,6,6,7,7,7,7,7,7,7,7,7,7,7,7,6,7,7,7,7,7,7,7,7,7,7,7,7,6,6,7,2,2,
    2,2,7,6,6,7,7,7,6,6,6,6,6,6,6,7,7,6,7,7,6,6,6,6,6,6,6,7,7,7,6,6,7,2,2,
    2,2,7,6,6,7,7,7,6,6,6,6,6,6,6,7,7,6,7,7,6,6,6,6,6,6,6,7,7,7,6,6,7,2,2,
    2,2,7,6,6,7,7,7,6,6,6,6,6,6,6,7,7,6,7,7,6,6,6,6,6,6,6,7,7,7,6,6,7,2,2,
    2,2,7,6,6,7,7,7,6,6,6,6,6,6,6,7,7,6,7,7,6,6,6,6,6,6,6,7,7,7,6,6,7,2,2,
    2,2,7,6,6,7,7,7,6,6,6,6,6,6,6,7,7,6,7,7,6,6,6,6,6,6,6,7,7,7,6,6,7,2,2,
    2,2,7,6,6,7,7,7,6,6,6,6,6,6,6,7,7,6,7,7,6,6,6,6,6,6,6,7,7,7,6,6,7,2,2,
    2,2,7,6,6,7,7,7,7,7,7,6,7,7,7,7,7,6,7,7,7,7,7,6,7,7,7,7,7,7,6,6,7,2,2,
    2,2,7,6,6,6,6,6,6,6,6,6,6,6,6,6,6,6,6,6,6,6,6,6,6,6,6,6,6,6,6,6,7,2,2,
    2,2,7,6,6,6,6,6,6,6,6,6,6,6,6,6,6,6,6,6,6,6,6,6,6,6,6,6,6,6,6,6,7,2,2,
    2,2,7,6,6,7,7,7,7,7,7,6,7,7,7,7,7,6,7,7,7,7,7,6,7,7,7,7,7,7,6,6,7,2,2,
    2,2,7,6,6,7,7,7,6,6,6,6,6,6,6,7,7,6,7,7,6,6,6,6,6,6,6,7,7,7,6,6,7,2,2,
    2,2,7,6,6,7,7,7,6,6,6,6,6,6,6,7,7,6,7,7,6,6,6,6,6,6,6,7,7,7,6,6,7,2,2,
    2,2,7,6,6,7,7,7,6,6,6,6,6,6,6,7,7,6,7,7,6,6,6,6,6,6,6,7,7,7,6,6,7,2,2,
    2,2,7,6,6,7,7,7,6,6,6,6,6,6,6,7,7,6,7,7,6,6,6,6,6,6,6,7,7,7,6,6,7,2,2,
    2,2,7,6,6,7,7,7,6,6,6,6,6,6,6,7,7,6,7,7,6,6,6,6,6,6,6,7,7,7,6,6,7,2,2,
    2,2,7,6,6,7,7,7,6,6,6,6,6,6,6,7,7,6,7,7,6,6,6,6,6,6,6,7,7,7,6,6,7,2,2,
    2,2,7,6,6,7,7,7,7,7,7,7,7,7,7,7,7,6,7,7,7,7,7,7,7,7,7,7,7,7,6,6,7,2,2,
    2,2,7,6,6,7,7,7,7,7,7,7,7,7,7,7,7,6,7,7,7,7,7,7,7,7,7,7,7,7,6,6,7,2,2,
    2,2,7,6,6,7,7,7,7,7,7,7,7,7,7,7,7,6,7,7,7,7,7,7,7,7,7,7,7,7,6,6,7,2,2,
    2,2,7,6,6,6,6,6,6,6,6,6,6,6,6,6,6,6,6,6,6,6,6,6,6,6,6,6,6,6,6,6,7,2,2,
    2,2,7,6,6,6,6,6,6,6,6,6,6,6,6,6,6,6,6,6,6,6,6,6,6,6,6,6,6,6,6,6,7,2,2,
    2,2,7,7,7,7,7,7,7,7,7,7,7,7,7,7,7,6,7,7,7,7,7,7,7,7,7,7,7,7,7,7,7,2,2,
    2,2,2,2,2,2,2,2,2,2,2,2,2,2,2,2,2,6,2,2,2,2,2,2,2,2,2,2,2,2,2,2,2,2,2,
    2,2,2,2,2,2,2,2,2,2,2,2,2,2,2,2,2,6,2,2,2,2,2,2,2,2,2,2,2,2,2,2,2,2,2,
    2,2,2,2,2,2,2,2,2,2,2,2,2,2,2,2,2,6,2,2,2,2,2,2,2,2,2,2,2,2,2,2,2,2,2,
    2,2,2,2,2,2,2,2,2,2,2,2,2,2,2,2,2,6,2,2,2,2,2,2,2,2,2,2,2,2,2,2,2,2,2,
    2,2,2,2,2,2,2,2,2,2,2,2,2,2,2,2,2,30,2,2,2,2,2,2,2,2,2,2,2,2,2,2,2,2,2
  ],
  "warps": [
    {"x": 17, "y": 0, "targetMap": "maps/area5_ocean.json", "targetX": 160, "targetY": 169, "type": "embark"},
    {"x": 17, "y": 34, "targetMap": "maps/area5_ocean.json", "targetX": 160, "targetY": 173, "type": "embark"},
    {"x": 11, "y": 14, "targetMap": "maps/prison_isle.json", "targetX": 15, "targetY": 28},
    {"x": 23, "y": 14, "targetMap": "maps/prison_isle.json", "targetX": 15, "targetY": 28}
  ],
  "npcs": [
    {"id": "prison_watcher", "x": 5, "y": 15, "sprite": "👁️", "type": "villager", "messages": ["...じっと見つめている..."]},
    {"id": "prison_ghost", "x": 30, "y": 20, "sprite": "👻", "type": "villager", "messages": ["ここから逃げ出せた者はいない...", "お前もすぐに我々の仲間入りだ..."]}
  ],
  "chests": [
    {"id": "prison_ext_chest", "x": 4, "y": 4, "itemId": 3, "itemName": "どくけし草", "isOpened": false}
  ],
  "encounterTable": "area5_prison",
  "encounterRate": 0.08
}
