{
  "mapId": "pyramid_f1",
  "name": "古のピラミッド",
  "type": "dungeon",
  "floor": 1,
  "parentDungeon": "pyramid",
  "cols": 20,
  "rows": 20,
  "isSafe": false,
  "encounterRate": 0.12,
  "encounterTable": "pyramid",
  "isOutdoor": false,
  "data": [
    [7,7,7,7,7,7,7,7,7,7,7,7,7,7,7,7,7,7,7,7],
    [7,6,6,6,6,6,6,6,6,6,6,6,6,6,6,6,6,6,6,7],
    [7,6,7,7,7,7,7,7,6,7,7,6,7,7,7,7,7,7,6,7],
    [7,6,7,6,6,6,6,6,6,6,7,6,6,6,6,6,6,7,6,7],
    [7,6,7,6,7,7,7,7,7,6,7,7,7,7,7,7,6,7,6,7],
    [7,6,7,6,7,6,6,6,6,6,6,6,6,6,6,7,6,7,6,7],
    [7,6,7,6,7,6,7,7,7,7,7,7,7,7,6,7,6,7,6,7],
    [7,6,6,6,7,6,7,6,6,6,6,6,6,7,6,7,6,6,6,7],
    [7,7,7,6,7,6,7,6,7,7,7,7,6,7,6,7,6,7,7,7],
    [7,6,6,6,7,6,7,6,7,6,6,7,6,7,6,6,6,6,6,7],
    [7,6,7,7,7,6,7,6,7,6,9,7,6,7,7,7,7,7,6,7],
    [7,6,6,6,6,6,7,6,6,6,6,6,6,7,6,6,6,6,6,7],
    [7,7,7,7,7,6,7,7,7,7,7,7,7,7,6,7,7,7,7,7],
    [7,6,6,6,6,6,6,6,6,6,6,6,6,6,6,6,6,6,6,7],
    [7,6,7,7,7,7,7,7,7,6,7,7,7,7,7,7,7,7,6,7],
    [7,6,6,6,6,6,6,6,6,6,6,6,6,6,6,6,6,6,6,7],
    [7,7,7,7,7,7,7,7,7,6,7,7,7,7,7,7,7,7,7,7],
    [7,6,6,6,6,6,6,6,6,6,6,6,6,6,6,6,6,6,6,7],
    [7,6,6,6,6,6,6,6,6,5,6,6,6,6,6,6,6,6,6,7],
    [7,7,7,7,7,7,7,7,7,7,7,7,7,7,7,7,7,7,7,7]
  ],
  "warps": [
    { "x": 9, "y": 18, "targetMap": "maps/desert_field.json", "targetX": 60, "targetY": 36 },
    { "x": 10, "y": 10, "targetMap": "maps/pyramid_f2.json", "targetX": 10, "targetY": 17, "stairType": "up" }
  ],
  "npcs": [],
  "chests": [
    { "id": "pyr1_chest1", "x": 5, "y": 5, "itemId": 1, "isOpened": false },
    { "id": "pyr1_chest2", "x": 14, "y": 5, "itemId": 3, "isOpened": false }
  ]
}
