{
  "mapId": "quicksand_cave",
  "name": "流砂の洞窟",
  "type": "dungeon",
  "floor": -1,
  "cols": 20,
  "rows": 20,
  "isSafe": false,
  "encounterRate": 0.15,
  "encounterTable": "quicksand_cave",
  "isOutdoor": false,
  "data": [
    [7,7,7,7,7,7,7,7,7,7,7,7,7,7,7,7,7,7,7,7],
    [7,6,6,6,6,7,7,7,7,7,7,7,7,7,6,6,6,6,6,7],
    [7,6,7,7,6,6,6,6,6,6,6,6,6,6,6,7,7,7,6,7],
    [7,6,7,7,7,7,7,7,7,6,7,7,7,7,6,7,6,6,6,7],
    [7,6,6,6,6,6,6,6,6,6,6,6,6,6,6,7,6,7,7,7],
    [7,7,7,7,7,7,7,7,7,6,7,7,7,7,6,7,6,6,6,7],
    [7,6,6,6,6,6,6,6,6,6,6,6,6,7,6,6,6,7,6,7],
    [7,6,7,7,7,7,7,7,7,7,7,7,6,7,7,7,7,7,6,7],
    [7,6,7,6,6,6,6,6,6,6,6,6,6,6,6,6,6,6,6,7],
    [7,6,7,6,7,7,7,7,7,7,7,7,7,7,7,7,7,7,6,7],
    [7,6,6,6,6,6,6,6,6,6,6,6,6,6,6,6,6,7,6,7],
    [7,7,7,7,7,7,7,7,7,7,7,7,7,7,7,7,6,7,6,7],
    [7,6,6,6,6,6,6,6,6,6,6,6,6,6,6,6,6,7,6,7],
    [7,6,7,7,7,7,7,7,7,7,7,7,7,7,7,7,7,7,6,7],
    [7,6,6,6,6,6,6,6,6,6,6,6,6,6,6,6,6,6,6,7],
    [7,7,7,7,7,7,7,6,7,7,7,7,7,7,7,7,7,7,6,7],
    [7,6,6,6,6,6,6,6,6,6,6,6,6,6,6,6,6,7,6,7],
    [7,6,7,7,7,7,7,7,7,7,7,7,7,7,7,7,6,7,6,7],
    [7,6,6,6,6,6,6,6,6,6,6,6,6,6,6,6,6,6,6,7],
    [7,7,7,7,7,7,7,7,7,7,7,7,7,7,7,7,7,7,7,7]
  ],
  "warps": [
    { "x": 1, "y": 1, "targetMap": "maps/desert_field.json", "targetX": 20, "targetY": 46 }
  ],
  "npcs": [
    { "id": "quicksand_boss", "x": 18, "y": 18, "sprite": "🌊", "type": "boss", "bossId": "quicksandBoss", "messages": ["この洞窟は我が支配する領域だ...", "清らかな水を求める者よ、まずは我を倒せ！"] }
  ],
  "chests": [
    { "id": "qs_chest1", "x": 18, "y": 1, "itemId": 1, "isOpened": false },
    { "id": "qs_chest2", "x": 3, "y": 8, "itemId": 2, "isOpened": false },
    { "id": "qs_chest3", "x": 1, "y": 18, "itemId": 30, "isOpened": false, "requiresBossDefeated": "quicksandBoss" }
  ]
}
