{
  "mapId": "siren_palace",
  "name": "セイレーン宮殿",
  "cols": 25,
  "rows": 25,
  "tileSize": 32,
  "isOutdoor": false,
  "isUnderwater": true,
  "type": "dungeon",
  "data": [
    7,7,7,7,7,7,7,7,7,7,7,7,7,7,7,7,7,7,7,7,7,7,7,7,7,
    7,7,7,7,7,7,7,7,7,7,7,6,6,6,7,7,7,7,7,7,7,7,7,7,7,
    7,7,7,7,7,7,7,7,7,7,7,6,6,6,7,7,7,7,7,7,7,7,7,7,7,
    7,7,7,7,7,7,7,7,7,6,6,6,6,6,6,6,7,7,7,7,7,7,7,7,7,
    7,7,7,7,7,7,7,7,6,6,6,6,6,6,6,6,6,7,7,7,7,7,7,7,7,
    7,7,7,7,7,7,7,6,6,6,6,6,6,6,6,6,6,6,7,7,7,7,7,7,7,
    7,7,7,7,7,7,6,6,6,6,6,6,6,6,6,6,6,6,6,7,7,7,7,7,7,
    7,7,7,7,7,6,6,6,6,6,6,6,6,6,6,6,6,6,6,6,7,7,7,7,7,
    7,7,7,7,7,6,6,6,7,7,7,6,6,6,7,7,7,6,6,6,7,7,7,7,7,
    7,7,7,7,7,6,6,6,7,7,7,6,6,6,7,7,7,6,6,6,7,7,7,7,7,
    7,7,7,7,7,6,6,6,7,7,7,6,6,6,7,7,7,6,6,6,7,7,7,7,7,
    7,7,7,7,7,6,6,6,6,6,6,6,6,6,6,6,6,6,6,6,7,7,7,7,7,
    7,7,7,7,7,6,6,6,6,6,6,6,6,6,6,6,6,6,6,6,7,7,7,7,7,
    7,7,7,7,7,6,6,6,6,6,6,6,6,6,6,6,6,6,6,6,7,7,7,7,7,
    7,7,7,7,7,6,6,6,7,7,7,6,6,6,7,7,7,6,6,6,7,7,7,7,7,
    7,7,7,7,7,6,6,6,7,7,7,6,6,6,7,7,7,6,6,6,7,7,7,7,7,
    7,7,7,7,7,6,6,6,7,7,7,6,6,6,7,7,7,6,6,6,7,7,7,7,7,
    7,7,7,7,7,6,6,6,6,6,6,6,6,6,6,6,6,6,6,6,7,7,7,7,7,
    7,7,7,7,7,7,6,6,6,6,6,6,6,6,6,6,6,6,6,7,7,7,7,7,7,
    7,7,7,7,7,7,7,6,6,6,6,6,6,6,6,6,6,6,7,7,7,7,7,7,7,
    7,7,7,7,7,7,7,7,6,6,6,6,6,6,6,6,6,7,7,7,7,7,7,7,7,
    7,7,7,7,7,7,7,7,7,6,6,6,6,6,6,6,7,7,7,7,7,7,7,7,7,
    7,7,7,7,7,7,7,7,7,7,7,6,6,6,7,7,7,7,7,7,7,7,7,7,7,
    7,7,7,7,7,7,7,7,7,7,7,6,6,6,7,7,7,7,7,7,7,7,7,7,7,
    7,7,7,7,7,7,7,7,7,7,7,7,7,7,7,7,7,7,7,7,7,7,7,7,7
  ],
  "warps": [
    {"x": 12, "y": 24, "targetMap": "maps/ocean_floor.json", "targetX": 19, "targetY": 26},
    {"x": 12, "y": 1, "targetMap": "maps/coral_maze.json", "targetX": 10, "targetY": 28}
  ],
  "npcs": [
    {"id": "palace_guard1", "x": 8, "y": 12, "sprite": "🧜‍♂️", "type": "villager", "messages": ["セイレーン様への謁見は許可されていない。"]},
    {"id": "palace_guard2", "x": 16, "y": 12, "sprite": "🧜‍♂️", "type": "villager", "messages": ["人間がここに来るとは珍しい..."]},
    {"id": "palace_maid", "x": 6, "y": 7, "sprite": "🧜‍♀️", "type": "villager", "messages": ["セイレーン様は美しい歌声をお持ちです。", "でも、その歌には恐ろしい力が..."]},
    {"id": "palace_elder", "x": 18, "y": 7, "sprite": "🧓", "type": "villager", "messages": ["昔、この宮殿には多くの人魚が住んでいた。", "今はセイレーン様の支配下にある..."]}
  ],
  "chests": [
    {"id": "palace_chest1", "x": 6, "y": 17, "itemId": 140, "itemName": "人魚の涙", "isOpened": false},
    {"id": "palace_chest2", "x": 18, "y": 17, "itemId": 5, "itemName": "聖水", "isOpened": false}
  ],
  "encounterTable": "area5_atlantis",
  "encounterRate": 0.06
}
