{
  "mapId": "wedge_dungeon_north_b1",
  "name": "北の祭壇・地下1階",
  "type": "dungeon",
  "cols": 25,
  "rows": 25,
  "isSafe": false,
  "encounterRate": 0.12,
  "encounterTable": "wedge_dungeon_b1",
  "isOutdoor": false,
  "area": "area3",
  "theme": "ice",
  "data": [
    [7,7,7,7,7,7,7,7,7,7,7,7,7,7,7,7,7,7,7,7,7,7,7,7,7],
    [7,6,6,6,6,6,6,7,6,6,6,6,6,6,6,6,6,7,6,6,6,6,6,6,7],
    [7,6,7,7,7,7,6,7,6,7,7,7,7,7,7,7,6,7,6,7,7,7,7,6,7],
    [7,6,7,6,6,6,6,6,6,6,6,6,6,6,6,6,6,6,6,6,6,6,7,6,7],
    [7,6,7,6,7,7,7,7,7,7,7,6,7,7,7,7,7,7,7,7,7,6,7,6,7],
    [7,6,6,6,6,6,6,6,6,6,6,6,6,6,6,6,6,6,6,6,6,6,6,6,7],
    [7,7,7,7,7,7,6,7,7,7,7,7,7,7,7,7,7,7,6,7,7,7,7,7,7],
    [7,6,6,6,6,6,6,6,6,6,6,6,6,6,6,6,6,6,6,6,6,6,6,6,7],
    [7,6,7,7,7,7,7,7,7,6,7,7,7,7,7,6,7,7,7,7,7,7,7,6,7],
    [7,6,6,6,6,6,6,6,6,6,6,6,6,6,6,6,6,6,6,6,6,6,6,6,7],
    [7,6,7,6,7,7,7,7,6,7,7,7,7,7,7,7,6,7,7,7,7,6,7,6,7],
    [7,6,7,6,6,6,6,6,6,6,6,6,6,6,6,6,6,6,6,6,6,6,7,6,7],
    [7,6,7,7,7,7,7,6,7,7,7,10,7,7,7,6,7,7,7,7,7,7,7,6,7],
    [7,6,6,6,6,6,6,6,6,6,6,6,6,6,6,6,6,6,6,6,6,6,6,6,7],
    [7,6,7,6,7,7,7,7,6,7,7,7,7,7,7,7,6,7,7,7,7,6,7,6,7],
    [7,6,7,6,6,6,6,6,6,6,6,6,6,6,6,6,6,6,6,6,6,6,7,6,7],
    [7,6,7,7,7,7,7,7,7,6,7,7,7,7,7,6,7,7,7,7,7,7,7,6,7],
    [7,6,6,6,6,6,6,6,6,6,6,6,6,6,6,6,6,6,6,6,6,6,6,6,7],
    [7,7,7,7,7,7,6,7,7,7,7,7,7,7,7,7,7,7,6,7,7,7,7,7,7],
    [7,6,6,6,6,6,6,6,6,6,6,6,6,6,6,6,6,6,6,6,6,6,6,6,7],
    [7,6,7,6,7,7,7,7,7,7,7,6,7,7,7,7,7,7,7,7,7,6,7,6,7],
    [7,6,7,6,6,6,6,6,6,6,6,6,6,6,6,6,6,6,6,6,6,6,7,6,7],
    [7,6,7,7,7,7,6,7,6,7,7,7,7,7,7,7,6,7,6,7,7,7,7,6,7],
    [7,6,6,6,6,6,6,7,6,6,6,6,5,6,6,6,6,7,6,6,6,6,6,6,7],
    [7,7,7,7,7,7,7,7,7,7,7,7,7,7,7,7,7,7,7,7,7,7,7,7,7]
  ],
  "warps": [
    { "x": 12, "y": 23, "targetMap": "maps/underworld_3.json", "targetX": 50, "targetY": 25 },
    { "x": 12, "y": 12, "targetMap": "maps/wedge_dungeon_north_b2.json", "targetX": 15, "targetY": 28 }
  ],
  "npcs": [],
  "chests": [
    { "id": "wedge_north_b1_chest1", "x": 3, "y": 3, "itemId": 2, "isOpened": false },
    { "id": "wedge_north_b1_chest2", "x": 21, "y": 21, "itemId": 5, "isOpened": false }
  ]
}
