{
  "mapId": "wedge_dungeon_east_b3",
  "name": "東の祭壇・地下3階",
  "type": "dungeon",
  "cols": 20,
  "rows": 20,
  "isSafe": false,
  "encounterRate": 0,
  "encounterTable": "wedge_dungeon_b3",
  "isOutdoor": false,
  "area": "area3",
  "theme": "fire",
  "data": [
    [7,7,7,7,7,7,7,7,7,7,7,7,7,7,7,7,7,7,7,7],
    [7,6,6,6,6,6,6,6,6,6,6,6,6,6,6,6,6,6,6,7],
    [7,6,7,7,7,7,7,7,6,6,6,6,7,7,7,7,7,7,6,7],
    [7,6,7,6,6,6,6,6,6,6,6,6,6,6,6,6,6,7,6,7],
    [7,6,7,6,7,7,7,7,7,6,6,7,7,7,7,7,6,7,6,7],
    [7,6,6,6,6,6,6,6,6,6,6,6,6,6,6,6,6,6,6,7],
    [7,6,7,6,7,6,7,7,7,6,6,7,7,7,6,7,6,7,6,7],
    [7,6,7,6,7,6,6,6,6,6,6,6,6,6,6,7,6,7,6,7],
    [7,6,7,6,7,7,7,6,7,6,6,7,6,7,7,7,6,7,6,7],
    [7,6,6,6,6,6,6,6,6,6,6,6,6,6,6,6,6,6,6,7],
    [7,6,6,6,6,6,6,6,6,6,6,6,6,6,6,6,6,6,6,7],
    [7,6,7,6,7,7,7,6,7,6,6,7,6,7,7,7,6,7,6,7],
    [7,6,7,6,7,6,6,6,6,6,6,6,6,6,6,7,6,7,6,7],
    [7,6,7,6,7,6,7,7,7,6,6,7,7,7,6,7,6,7,6,7],
    [7,6,6,6,6,6,6,6,6,6,6,6,6,6,6,6,6,6,6,7],
    [7,6,7,6,7,7,7,7,7,6,6,7,7,7,7,7,6,7,6,7],
    [7,6,7,6,6,6,6,6,6,6,6,6,6,6,6,6,6,7,6,7],
    [7,6,7,7,7,7,7,7,6,6,6,6,7,7,7,7,7,7,6,7],
    [7,6,6,6,6,6,6,6,6,6,9,6,6,6,6,6,6,6,6,7],
    [7,7,7,7,7,7,7,7,7,7,7,7,7,7,7,7,7,7,7,7]
  ],
  "warps": [
    { "x": 10, "y": 18, "targetMap": "maps/wedge_dungeon_east_b2.json", "targetX": 14, "targetY": 13 }
  ],
  "npcs": [
    {
      "id": "wedge_guardian_east",
      "x": 10,
      "y": 2,
      "sprite": "🔥",
      "type": "boss",
      "bossId": "wedgeGuardian_east",
      "messages": [
        "燃え盛る炎の試練...",
        "お前たちに耐えられるか？",
        "100年の孤独が...この炎をさらに激しくした。",
        "来い！ 我が炎で焼き尽くしてくれる！"
      ],
      "defeatedMessages": [
        "...見事だ。",
        "炎の試練を乗り越えたか...",
        "この楔を持っていけ。"
      ],
      "defeatFlag": "wedges.wedge_east",
      "wedgeId": "wedge_east"
    }
  ],
  "chests": []
}
